VOCAB ANGLAIS 

-

Henceforth -> dÃ©sormais, Ã  lâ€™avenir 

Runt -> nabot, avorton, freluquet 

Banter -> badinage, plaisanterie

Admist -> au milieu de, parmi

To embed -> intÃ©grer, enchÃ¢sser

Cab -> taxi

To shed light -> Ã©clairer 

Endowment -> donation

Skewness -> asymÃ©trie 

To bear fruit -> porter des fruits 

To ponder -> rÃ©flÃ©chir, considÃ©rer 

Hindrance -> obstacle 

Enticing -> sÃ©duisant, attrayant

Spillovers -> retombÃ©es

Lain -> couchÃ©, posÃ©, allongÃ©

A layman -> un laÃ¯c, un profane 

Reluctant -> rÃ©ticent

Attrition -> usure

Incumbent -> titulaire

To adduce -> apporter, fournir

Layoff -> licenciement, destitution

To plummet -> dÃ©gringoler

Outset -> dÃ©but, commencement 

Ledger -> registre

Thrift -> Ã©pargne 

To impede -> entraver

To bilk -> blouser

Insofar -> dans la mesure oÃ¹

Portfolio -> portefeuille 

Snuff -> tabac Ã  priser

To nod -> Hocher la tÃªte

Whisker -> moustache

Bristle -> poil

A scavenger -> un charognard 

To lash out -> fouetter

Dismay -> consternation 

A scabbard -> un fourreau 

To mend -> rÃ©parer, raccommoder, corriger 

To anneal -> recuire 

Vertices -> sommets

Vertex -> sommet

Alimony -> pension

Albeit -> quoique, bien que 

Hurdle -> obstacle, haie

To hurdle -> franchir 

To befall -> advenir, arriver Ã , se passer 

Frolicking -> gambader, batifolage

To chuck out -> renvoyer, mettre Ã  la porte

To boast -> se vanter, fanfaronner, se glorifier dâ€™avoir 

To be coralled into -> se rÃ©unir pour

To dawdle -> lambiner, flÃ¢ner, lanterner

Chintzy -> kitsch, vulgaire, voyant, fleuri, radin

To wrangle -> se disputer, se chamailler 

Mild -> doux, lÃ©ger

To bleach -> blanchir, javelliser, se dÃ©colorer 

Shingle -> galet

Thatch -> (toit de) chaume

Noxious -> nuisible 

To thresh -> battre 

An instar -> un stade (Ã©tape)

Oxen -> bÅ“uf 

A klin -> un four

Hoof -> sabot

Trimming -> garniture, taille, rognure

Sledge -> luge

A sled -> un traÃ®neau 

Coaster -> dessous de verre/bouteille 

To relinquish -> renoncer, abandonner 

Chin -> menton

Fedora -> le feutre 

To bestow (smth on sb) -> dÃ©cerner (qqch Ã  qqn), confÃ©rer, accorder 

Sluggish -> lÃ©thargique, paresseux, apathique, mou

Baleful -> funeste, sinistre 

An omen -> un prÃ©sage, un augure, une auspice

Custard -> crÃ¨me

Fancy -> sophistiquÃ©, chic, de luxe

Ritzy -> chic

Taut -> tendu, chic

Swanky -> chic 

Boorish -> rustre, grossier 

To frazzle -> crever, Ã©reinter 

Callow -> inexpÃ©rimentÃ©, novice 

To embezzle -> dÃ©tourner 

Eerily -> Ã©trangement 

Embezzlement -> dÃ©tournement de fonds 

Starkly -> tout Ã  fait 

Peonies -> pivoines 

Crimson -> cramoisi 

A pond -> un Ã©tang

A swamp -> un marais 

Lenient -> indulgent, clÃ©ment, tolÃ©rant 

Bulky -> volumineux, corpulent

Awe -> admiration, effroi mÃªlÃ© de respect

To bemoan -> dÃ©plorer 

To yearn (for) -> aspirer (Ã ), languir, sâ€™Ã©mouvoir 

To steep -> tremper, macÃ©rer, mariner

Infatuation -> engouement

An understudy -> une doublure

The yeast -> La levure 

Brisk -> rapide, brusque, vif, actif 

Pastry -> pÃ¢tisserie 

To tan -> bronzer, tanner, brunir

The Steering wheel -> le volant (voiture)

To be off -> sâ€™en aller, se tirer 

To stride away -> sâ€™Ã©loigner 

To stride -> arpenter, marcher Ã  grands pas 

To pamper -> dorloter, choyer, gÃ¢ter 

Earnest -> sÃ©rieux, sincÃ¨re, ardent, touchant 

To blend in -> se fondre dans

To strew -> parsemer, rÃ©pandre, Ã©parpiller

To squint -> loucher, plisser les yeux

Slump -> affaiblissement, marasme, effondrement  

To upend -> mettre debout, renverser 

To rehearse -> rÃ©pÃ©ter (pour une piÃ¨ce, ...)

Twerp -> andouille, idiot

To stoke up -> attiser

To underpin -> Ã©tayer

Forbearance -> abstention, patience, tolÃ©rance 

Ruthless -> impitoyable

Bosom -> le(s) sein(s), la poitrine

Muddle -> confusion, dÃ©sordre, cafouillage

creed -> le credo, les principes 

To curtail -> rÃ©duire, raccourcir, Ã©courter 

To uphold -> soutenir, maintenir, dÃ©fendre 

To withhold -> refuser de donner 

To bare -> dÃ©voiler (=uncover)

To prowl -> rÃ´der

Shoddy -> de mauvaise qualitÃ© 

Pumped-up -> gonfler Ã  bloc 

A boarder -> un interne 

Constituency -> circonscription Ã©lectorale 

To enact -> promulguer 

Wholesome -> sain 

To commit oneself -> sâ€™engager 

To lodge a complaint -> porter plainte 

Untapped -> inexploitÃ©

The depletion -> la diminution, lâ€™appauvrissement

The shortage -> la pÃ©nurie

Sewage [singulier] -> les eaux usÃ©es 

The glut -> la surabondance, lâ€™excÃ¨s

Absetos -> amiante

The tide -> la marÃ©e

Barren -> dÃ©sertique, aride, stÃ©rile

A sawmill -> une scierie

Bereft (of smth) -> perdu, dÃ©muni, privÃ© de qqch, dÃ©pourvu de qqch

Grudging -> rÃ©ticent 

To poach -> braconner

Bigotry -> sectarisme, intolÃ©rance 

To cash in -> vendre, profiter

Paramount -> premier, primordial, dâ€™importance capitale 

The stance -> la position, le point de vue 

To slant -> pencher, incliner 

Haywire -> dÃ©traquÃ© 

An upheaval -> un bouleversement 

A tenet -> un principe, une doctrine 

To pertain to smth -> se rapporter Ã  qqch, concerner qqch, dÃ©pendre, se rattacher 

Tantamount -> Ã©quivalent 

To hasten -> se dÃ©pÃªcher, se hÃ¢ter, prÃ©cipiter 

To abet -> encourager, soutenir, aider

A hodgepodge -> un fatras

A ditch -> un fossÃ© 

Detrimental -> nÃ©faste, nocif

To preclude smth -> empÃªcher qqchose (mÃªme usage que to prevent)

To hinder -> empÃªcher 

A fib -> un mensonge, un bobard

The sleight -> la dextÃ©ritÃ© 

To bamboozle -> dÃ©boussoler, emberlificoter 

Middlebrow -> sans grandes prÃ©tentions (intellectuelles), spectateur, lecteur moyen

Decidedly -> vraiment, rÃ©solument, fermement

A garment -> un vÃªtement 

Ubiquitous -> omniprÃ©sent 

To whinge -> rÃ¢ler, se plaindre 

To peddle -> colporter, rÃ©pandre, propager

To outflank -> dÃ©border, contourner, dÃ©jouer les manÅ“uvres 

The stewardship -> lâ€™administration, lâ€™intendance, la direction, la gÃ©rance 

The overhaul -> le remaniement, la rÃ©vision 

To behold -> regarder, contempler 

To seep -> suinter, couler, filtrer

To seep in -> sâ€™infiltrer, sâ€™insinuer dans

To ooze -> suinter, sâ€™infiltrer 

Queasy -> nausÃ©eux ğŸ¤¢ 

To kowtow to sb -> faire des courbettes devant qqn, se prosterner

A den -> une taniÃ¨re, un repaire

A clerk -> un employÃ©, un vendeur, un prÃªtre 

An outlier -> une valeur aberrante

To spurt/spirt -> gicler, jaillir, cracher 

Lewd -> obscÃ¨ne 

To boil down to smth -> se rÃ©sumer Ã  qqch

A keepsake -> un souvenir

To swell -> enfler, gonfler

To postpone -> remettre Ã  plus tard, reporter

An offshoot -> une ramification, un rejeton

To hamstring sb/smth -> paralyser, handicaper qqn/qqch

To forgo smth (forwent, forgone) -> renoncer Ã  qqch, abandonnÃ© 

To jettison -> abandonner, se dÃ©lester de 

To be prone to + ing -> Ãªtre enclin Ã  

To bedevil sb -> embrouiller, dÃ©ranger, tourmenter qqn

To allege (that) -> prÃ©tendre (que)

To assert -> affirmer que, dÃ©clarer que, faire valoir

To huddle -> se blottir, se regrouper en petit groupe

Buoyant -> flottable, actif, plein dâ€™entrain, ferme

Upbeat -> optimiste 

The thaw -> le dÃ©gel, la dÃ©tente 

A stronghold -> un bastion

The tusks -> les dÃ©fenses (dâ€™un animal)

To set someone back -> repousser qqn

A horn -> une corne 

A backstop -> un filet de sÃ©curitÃ©, un grillage

To deem sb/smth smth -> juger qqn/qqch qqch, estimer, considÃ©rer comme 

A sizzling -> un grÃ©sillement

To convey -> transmettre, communiquer, amener, informer

To supersede -> remplacer, prendre la place

Engregious -> Ã©norme

To deprive someone from something -> Ã´ter qqchose a qqn, priver, dÃ©pouiller, dÃ©possÃ©der 

Awry -> de travers, courbÃ©

Incitements -> la provocation, lâ€™incitation

To appal -> consterner, choquer, Ã©pouvanter, scandaliser, horrifier, rÃ©volter

To bail out -> renflouer, sauter en parachute, Ã©coper

Dire -> terrible, affreux, sinistre 

To thwart -> contrecarrer, contrarier, frustrer 

To fare -> rÃ©ussir, voyager 

Amid -> parmi, au milieu de, Ã  la suite de

To engulf -> engloutir, sombrer dans, engouffrer

Barring -> sauf, exceptÃ©, Ã  moins que 

To foster -> favoriser, encourager 

To thrive -> prospÃ©rer, se dÃ©velopper, rÃ©ussir 

To delve -> creuser, fouiller dans, Ã©tudier un sujet Ã  fond

To muster -> rassembler, regrouper 

To marshal -> rassembler, canaliser

To clump togother -> se regrouper

Skyrocketting -> qui croÃ®t exponentiellement 

To soar -> grimper, monter en flÃ¨che 

To startle -> surprendre, effaroucher, Ã©tonner, faire peur

The twinge -> le pincement

Thereby -> Ainsi

A Loon -> un dingue, Un plongeon

Bereaved -> privÃ©, dÃ©possÃ©dÃ©

Given that -> Ã©tant donnÃ© que 

To bellow -> beugler

To overstep -> dÃ©passer, aller trop loin

The discretion -> le discernement 

To bribe -> soudoyer, offrir des pots de vins 

The clout -> lâ€™influence, le coup, le poids, le tissu/chiffon

The wont -> lâ€™habitude, la coutume 

Barefoot -> pieds nus

To teem -> grouiller, fourmiller

The conceit -> lâ€™arrogance, la vanitÃ©

To smear -> barbouiller, salir, Ã©taler 

Rugged -> robuste, solide, rugueux

The wit -> lâ€™esprit

Dismal -> lugubre, triste, sombre

To rave -> dÃ©lirer, divaguer

The brow -> le front

To sort (sth) out -> sâ€™occuper de qqch

To mellow -> sâ€™adoucir 

To soften -> sâ€™adoucir

To fetch -> rapporter, aller chercher

Sorrowful -> malheureux (pour une personne)

To mumble -> marmonner, parler entre ses dents

To stutter -> bÃ©gayer

To Stammer -> bafouiller, bÃ©gayer

The boot -> le coffre (de la voiture)

A/the span -> une durÃ©e, la portÃ©e, lâ€™envergure 

Eager -> fervent, ardent, de passionÃ©, avide

An orchard -> un verger

Foul -> infect, ignoble, odieux, pourri, mauvais

Thews -> les muscles

A proponent -> un partisan

To dull -> ternir

A hoop -> un cerceau

A quarry -> une carriÃ¨re

A quarrel -> une querelle

Gaudy -> voyant, brillant, ornÃ© avec mauvais goÃ»t 

The loan -> le prÃªt, lâ€™emprunt 

The moisture -> lâ€™humiditÃ© 

To assess -> Ã©valuer

To instill -> insuffler, faire comprendre 

Woe -> malheur 

A funnel -> un entonnoir

Grim -> sombre

Utter -> total, absolu, complet

Whence -> dâ€™oÃ¹

To lambast -> descendre en flamme ğŸ”¥

To whine -> se lamenter, gÃ©mir 

To hush -> faire taire 

To hush up -> Ã©touffer

Hushed -> Ã©touffÃ©

To choke -> sâ€™asphyxier 

Stifling -> Ã©touffant, suffocant 

Deeds -> des actes

To loom -> se profiler, menacer, se dessiner

Gloomy -> morne 

Sullen -> morne, triste 

Bleak -> morne, triste, lugubre

Dim -> faible

Dull -> terne, ennuyeux, monotone

A venture -> une entreprise, un projet

The slumber -> le sommeil ğŸ’¤ 

A yawn -> un bÃ¢illement 

To shiver -> frissonner, trembler, frÃ©mir

An eyesore -> une horreur

Staggering -> stupÃ©fiant

Shabby -> minable

A swirl -> un tourbillon

Genuine -> authentique, vÃ©ritable

A clatter -> un bruit 

A squawk -> un cri

To Loathe -> dÃ©tester

Betwixt -> entre

To beseech -> supplier, implorer

The pettiness -> la petitesse

To hand off -> remettre

To crave smth -> brÃ»ler dâ€™envie de qqchose

Feebleminded -> faible dâ€™esprit 

To gawk -> rester bouche bÃ©e

To stare -> fixer, regarder longuement

Cozy -> confortable 

Sorely -> grandement, fortement

A fiend -> un dÃ©mon

Lofty -> noble 

Slack -> mou 

A Gaze -> un regard

To team up -> faire Ã©quipe 

To hog -> sâ€™accaparer 

To fathom -> sonder, comprendre

Fathoms -> brasses (= 1.83m)

A fang -> un croc

A Showdown -> une confrontation, Ã©preuve de force

A sigh -> un soupir 

A Staple -> une agrafe

To slip away -> sâ€™Ã©clipser

Giddy -> Ã©tourdi

To enquire -> renseigner, se renseigner, sâ€™enquÃ©rir 

To jest -> plaisanter 

To tag along -> marquer

Blunt -> Ã©moussÃ©

To glom onto -> glisser sur 

The latter -> le dernier

To shape up -> faÃ§onner

Bitter -> amer 

To doze off -> somnoler

A wimp -> une mauviette

To meddle -> se mÃªler

The dread -> la crainte

Dreaded -> redoutÃ©

To single out -> distinguer

An excerpt -> un extrait

To drawl -> parler dâ€™une voix traÃ®nante 

To throw off -> jeter

Peculiar -> particulier

Broad -> vaste

The rust -> la rouille

To snatch -> arracher

To spew -> vomir ğŸ¤® 

Contempt(uous) -> mÃ©pris(ant)

Screenful -> criblÃ©

Ghast -> affreux, horrible 

A burden -> un fardeau

To fan -> sâ€™Ã©vaporer

To mingle -> se mÃ©langer

A pendant -> un pendentif

The glare -> lâ€™Ã©blouissement

To mope -> broyer du noir, se morfondre

The fealty -> allÃ©geance, fidÃ©litÃ©

Flawless -> impeccable

Spotless -> impeccable, trÃ¨s propre

To smirk -> sourire en coin 

A grin -> un sourire

To surmise -> conjecturer 

To partake -> participer

The gist -> lâ€™essentiel

Sly -> sournois

To scold -> gronder 

blackmail -> chantage

Dastardly -> ignoble, odieux

The bride -> la mariÃ©e

Muddled -> embrouillÃ©

To get dumped -> se faire larguer

Stingy -> avare

To have rabies -> avoir la rage

Gossips -> ragots, bavardages

To tease -> taquiner

To scatter -> disperser, Ã©parpiller, rÃ©pandre, dissÃ©miner, parsemer, saupoudrer

An assumption -> une supposition

A trickster -> un filou

A conman -> un escroc

A riffraff -> une racaille

A rascal -> un chenapan, une fripouille

To fuss -> sâ€™agiter, faire des histoires

To crawl out of -> se glisser hors de

Clingy -> collant, moulant

To heed smth -> faire attention Ã  qqchose, tenir compte de qqchose

Disclosure -> divulgation

Bashful -> timide, pudique

Remote -> Ã©loignÃ©, isolÃ©, reculÃ©

Astray -> Ã©garÃ©

To bargain -> marchander 

A bargain -> une bonne affaire, une aubaine

A hose -> un tuyau dâ€™arrosage 

A lighthouse -> un phare

Cabbage -> chou

To bury -> enterrer

The mainstay -> pilier, base

Eating patterns -> habitudes alimentaires

To entail -> impliquer, causer, entraÃ®ner 

To go over -> Ãªtre reÃ§u 

To go over smth -> voir, passer en revue, examiner

A scrounger -> un pique-assiette, un parasite, un profiteur 

A conundrum -> un casse-tÃªte, une Ã©nigme 

A crackdown -> une mesure rÃ©pressive, rÃ©pression 

To put a strain on smth -> peser sur qqch

Weeping -> larmoyant, pluvieux

A (weeping) willow -> un saule (pleureur)

To devote -> consacrer 

Broad -> large, vaste

Stomped -> piÃ©tinÃ©

A glint -> une lueur, un reflet

To hoot at sb -> huer qqn 

Staggering -> stupÃ©fiant

To pour -> verser

To prick -> piquer, percer

To shrug -> hausser les Ã©paules ğŸ¤·â€â™‚ï¸ 

To frown -> froncer les sourcils

Beneath -> sous

Oblivious -> inconscient

Stirring -> Ã©mouvant, vibrant

To stir -> bouger, mÃ©langer, touiller, remuer

A liegeman -> un vassal (archaÃ¯que)

Hollow -> creux, vide, faux, dissimulÃ©

Sunken -> creux

To simmer -> mijoter, bouillonner 

A stakeholder -> un intervenant, un responsable, une partie intÃ©ressÃ©e 

To scrawl -> gribouiller, griffonner 

To back out -> se retirer, faire machine arriÃ¨re 

To linger -> sâ€™attarder, traÃ®ner, rester 

To linger over smth -> prendre son temps sur qqch

To dwell upon smth -> sâ€™attarder sur qqchose

To lay the stress on -> insister sur, mettre lâ€™accent sur

To sprawl -> sâ€™Ã©taler, sâ€™affaler, Ãªtre vautrÃ©, sâ€™Ã©tendre 

To loth to do smth -> rÃ©pugner Ã  faire qqch

A bone of contention -> un sujet de dispute 

To be deadlocked -> Ãªtre dans lâ€™impasse 

To tumble -> tomber, valdinguer, chuter, rouler 

A backlash -> rÃ©action violente contre

Retaliation -> riposte, reprÃ©sailles, contre-attaque, vengeance